1111111111111111111111111111111111
1E0000000000000C00000C000000000001
1010010100100000101001000000010101
1010010010101T10001001000T00010101
1P000T000C00C0000000T00000000000C1
1111111111111111111111111111111111
