1111111111111
100000P0000C1
1000011111111
1000000000001
100000EE00001
1111111111111
