1111111111111
10010000P00C1
1000011111111
1C0000E000001
100T0000T00C1
1111111111111
