1111111111111
100001P1000C1
1000011111111
1000000000001
100000E000001
1111111111111
