1111111111111
100000P0000C1
1000011111111
10000000000011
100000EE00001
1111111111111
