11111111111111111111111111111111111111111111111111111111
10000000000000000000000000000000000000000000000000000001
10111111111111000000000000000001111111111111000000000001
10000000000001000000000000000001000000000001000000000001
10000000000001111111111111100001000000000001000000000001
10000000000000000000000100000001000011111001000000000001
11111111111110000000100100000001001000001001000000000001
10000000000110000000100100000001001000001001111110000001
10000000000110001111100100000001001000001000000010000001
10000000000110000000000100000001001000001000000010000001
10000000000110000000000111111111001111111000000010000001
10000000000110000000000000000000000000000000000010000001
10000000000110000000000000000000000000000000000010000001
10000000000111111111000000000000000000000000000E10000001
10000000000000000000000011111111111111111111111110000001
10000000000000000000000010000000000000000000000000000001
1000000000000000000E000010000000000000000000000000000001
10000010000000000000000010000000000000000000000000000001
1000001000000000P000000100000000000000000000000000000001
10000010000000000000000010000000000000000000000000000001
1000001000000000C000000100000000000000000000000000000001
10000010000000000000000010000000000000000000000000000001
10000000000000000000000000000000000000000000000000000001
10000000000000000000000000000000000000000000000000000001
11111111111111111111111111111111111111111111111111111111