11111111111111111111111111111111111111111111111111111111
10000000000000000000000000001000000000000000000000000001
1000000000000000000000000001C100000000000000000000000001
10000000000000000000000000100010000000000000000000000001
10000000000000000000000001000001000000000000000000000001
10000000000000000000000001000001000000000000000000000001
10000000000000000000000001000001000000000000000000000001
10000000000000000000000001000001000000000000000000000001
10000000000000000000000001000001000000000000000000000001
10000000000000000000000000000000000000000000000000000001
10000000011100000000000000000000000000000000111000000001
11000000100000000000000000000000000000000000000100000011
1C11111100000000000000000000P0000000000000000000111111C1
10000000000000000000000000000000000000000000000000000001
10000000000000000000000000C0E0C0000000000000000000000001
1C1111110000000000000000000000000000000000000000111111C1
11000000100000000000000000000000000000000000000100000011
10000000011100000000000000000000000000000000111000000001
10000000000000000000000000000000000000000000000000000001
10000000000000000000000001000001000000000000000000000001
10000000000000000000000001000001000000000000000000000001
10000000000000000000000001000001000000000000000000000001
10000000000000000000000001000001000000000000000000000001
10000000000000000000000001000001000000000000000000000001
10000000000000000000000000100010000000000000000000000001
1000000000000000000000000001C100000000000000000000000001
10000000000000000000000000001000000000000000000000000001
11111111111111111111111111111111111111111111111111111111