11111111111111111111111111111111111111111111111111111111
1000000000000000000000000000000000000000000100001C01C1C1
1C0000000000000000000010C100C1010000000000C1000010010101
11111111100000000111111111111101111111111111000010010101
10000000000000000000000000000000000000000000000010010101
10000000000000000000000000000000000000000000000010010101
1C000000000000000000000000000000000000111111111110010101
11111111000000000000000000000000000000000000000000000001
10000000000000000000111111000000000000000001000100000001
100000000000000000001C00C1000000000000100001000100000001
1C000000000000000000100001000000000000100001000100000001
11111110000000000000100001000000001111111111111111111111
10000000000000000000100001000000000000000000000000000001
10000000000000111111100001111110000000000000000000000001
100000000000001C0000000000000C10001111111110111111111111
10000000000000100000100001000010001000000000000000000001
10001000000100000000100P01000000001000000000000000000001
10001000000100100000100001000010001001111111111111111101
100010111111001C0000000000000C10001001000000000000000001
10001000000100111111100001111110001001000000000000000001
10001000000100000000100001000000001001001111111111111101
10001111110100000000100001000000001001001000000000000001
10001000000100000000100001000000001001001000000000000001
10001011111100000000100001000000001001001000000000000001
1000100000C1000000001C00C1000000001001001000000111111101
10001011111100000000111111000000001001001000000100000001
1CCC100000C100000000000000000000001CC1CC10C0C001E0000001
11111111111111111111111111111111111111111111111111111111