1111111111111
10010000P00C1
1001011111111
1000000000001
100000E000001
1111111111111
