1111111111111
10010000P00C1
1000011111111
100000E000001
10T0000000001
1111111111111
