1111111111111111111111111111111111111111111
1E0000000000000C00000C000000000000000000001
1010010100100000101001000000010101010101011
1010010010101010001001000000010101010101011
1P0000000C00C0000000000000000000000000000C1
1010101010101010101010101010101010101010101
1010000000000000000000000000000000000000001
1010111111111111111111111111111111111111101
1010000000000000000000000000000000000000001
1111111111111111111111111111111111111111111
